BBBBBBBBBBBBBBBBBBBBBBBBBBBBBBBBBBBBBBBBBBBBBBBBBBBBBBBBBBBBBBBBBBBBBBBBBBBBBBBBBBBBBBBBBBBBBBBBBBBB
BBBBMMMBBBBBBBBBBBMMMMMMMBBBMMMBMMBBMBBBBBMMMMMMMMBBBMMMMMBBMBBBBMMMMMBBBMMMBBBBBBBMMBBBMMMBBMMMBBBB
BBMMMMMMMMMMBBBMMMMMMMMMMMMMMMMMMMMMTMMMMMMMMMMMMMBBBBMMMMMMMMMMMMMMMMMMMMMMMMMBBBMMMBBMMBBBMMMMMBBB
BMMMMTMMMMMMMMMMMMMMMMMMMMMMMMMMMMTTMMMMMTMMMTMMMMBMMMMTMMMMMMMMMMMMMMMMMMMMMMMMMMMMMMMMMMMMMMMMMBBB
BMMMMMMMMMMSMMMMMMMMMMMMMMMMMMMMMMMMTTMMMMTTMMMMTMMMMMMMMMMMMMTMMMMMMMMMMMMMMTMMMMMMMMMMMMMMMMMMMBBB
BBBMMMMMMMMMMMMMMMMMMMMMIMMMMMMMMMTTTTTTTTTTTTTTMMMMTMMMMMMMMTMMMMMMMMTMMMMMMTMMMMMMMMMMMMMMTMMMMMBB
BBBMMMMMMMMMMMMMMIMMMMMMMMMMMMMMMMMTTTTTTTTTMMMTMMMTMMMMMMTTTTMMMMTMMMMTTTMMMMMMTTTMMMIMMMMMMMMMMMMB
BBMMMIMMMMTTMMMMMMMMMMMMMMMMTMMMMMMMTTTTMMMMTMMMMTMTMMMMMMMTTTTTMMMMMMMTVVVVVMTMTMMMMMMMMMMMMMMMMMMB
BBMMMMMMMMTMMMMMMMMMMMMMMMMMMMMMMMMMMMMMMMTTTTMMMMMMMMMMTMMTTTTMTMMMMMMVVVVVVMMTTMMMMMMMMMMMMMMMMMBB
BMMMMIMMMMMMMMMMMMMMMMMMMIMMMMMMMBBBBBBBBBBBBBBBBBBMMMMMMMMTTMMMMMMMMMMVVVMMTTTTTTTTTMMMMMMMMMTMMMBB
BBMMMMMMMTMTTMMMMMMMMMMMMMMMMMMMBBBBBBBBBBBBBBBBBBBBMMMMMMMTTMTMMMMMMMMVVVMMMMMTTTTTTMMMMMMMMMMMMMBB
BBMMMMMMTTTTMMMMMMMMMMMMMMMMMBBBBBBBBBBBBBBBBBBBBBBBBMMMMMMTMTMMMMMMMMMMMMMMMMMMMMTTTTMTMMMMTMMMMMMB
BMMTMMMMMMMMMMMMMMMMMMMMMMMMBBBBBBBBBBBBBBBBBBBBBBBBMMMMMMMTMMMMMMMMMMMMMMMMMMMMMMMTTTTMTMMTMMMMMMBB
BMMMTTMMMMMMMMMMMMMMMMTMMMMMIBBBBBBBBBBBBBBBBBBBBBBBMMMMMMMMMMMMMMMMMMMMMMMMMMMIMTMMTTTTMMMMMMMMMMBB
BMMMTTMMMTTTMMTTTMMMMMMMMMMMIMMMMBBMMMMBBBBMMBBBBBBMMMMMMMMMMMMMMMMMMMMMMMMMMMMMMMMMMTTTTTTTMMMMMMBB
BMMMTMMTTTTTMMTMMMMMMMMMMMMMMMMMMMMMMMMMMMMMMBBBBBBMMMMMMMMMMMMMMMMMMMMMMMMMMMMMMMMTMTTTTTTTTMMMMBBB
BBMMMTTTTTTTTMMMMMMMMMMMMMMMMMMMMMMMMMMMMMMMMMMMMMMMMMMMMMMMMMMMMMMMMMMIMMTMMMMMMMMTTMMTTTTTTMMMMBBB
BMMTTMTTTTTMMMMMTMMMMMMMMMMMMMMMMMMMMMMMMMMMMMMMMMMMMMMMMMMMMMMTMMMMMMMMMMMMMMMMMMMMMMMMTTMMMMMMMBBB
BMMTTTTTTTTTTTMMMMMMMIMMMMMMMMMMMMMMMMMMMMMMMMMMMMMMMMMMMMMMMMMMIMMMMMMMMMMMMMMMMMMMMMTTMMMMMMMMMBMB
BBMMTTTTTTMTTTTMMMMMMMMMMMMTMMMMMMTTTMMMMMTMMMMMMTTMMMMMMMMMMMMMMMMMMMMMMMMMMMMMMMMMMMTTMMMMMMMMMMMB
BMMMMMMMMTMTTMMMMMMMMMMMMMTMMMMMMMMMTTTMMTMMMMMMMTTTTTMMMMMMMMMMMMMMMMMMMTTTMMMTMMMMMMTTMMMMMMMMMMMB
BMMMMMMTTTTMMMMMMMMMMMMMMTTMMMMMTTMTTMMMMMMMMMMMMMMTTTTTMTMMMMMMMMMMMMMMTTTTTTMMTMMTTMTMMMMMMMMMTMBB
BBMMMMMMTMMTTMMMMMMMMMMMTTTMMMMMMMIMMMMMMMMMIMMMMMMMMTTTTMMMMMMMMMMMMMMTTTTTTTMMTTTTTTTMMMMTTMMTMMBB
BBMTMMMMMTMMMMTMMMMMMMMMTMMMMMMMMMMMMMMMMMMMMMMMMMMMMMTTTTMMMMMMMMMMMMMMMTTTTTMMMTTTTTTTTTTTMMMMMBBB
BBTTTMMTTTTMMTMTTMMMMMMTTMMMMMMMMMMMMMMMMIMMMMMMMMMMMMTTTTMTMMMMMMMMMMMMMMMTTMMMTTVVTTTTMMTTMMMBBBBB
BBMTTTMMMMMMMMTMMMMMMMMTMMMMMMMMMTMMMMMMMMMMMMMMMMMMMMMTTTMMMMMMMMMMMMMMMMMMMMTTTGGVVTTMMMMMMMMMMBBB
BMTTTTMTMMMMMMMMMMMMMMTTMMMMMMTTMMMMMMMMMMMMMMMMMMMMMMMTMMMTMMMMMTTMMMMMMMMMGGTGGGGVTTMMMTMMMMMMMMBB
BBMMMMMMMMMMMTMMMMMMMTTTMMMMMMMMMMMTTMMMMMMMMMMMMMMMIMMMMMMMMMMMTTMTIMMMMMMGGGGGGVVVTTMMMTMMMMMMMMMB
BBMMMMMTMMMMMMTMMMMMTTTTTMMMMMMMMTTTMMMMMMMMMMMMMMMMMMMMMTTMMTMMTTTMMMMMGGGGGGGGVVVVTTTMMMMMMTMMMMMB
BMMMMMMMMMMMMMMMMMTMMTTTTMMMMMMMMTTMMMMMMMMMMMMMMMMMMMMMMMMTTTTTTTMMMTTGGVVVVVVVVVVVTTTMMMMMMMMMMMBB
BMMMMMMMMMBBMMMMMMMMMTTTMMMMMMMMMTTMTMMMMMMMTMMMMMMMMMTTTTTTTTTTTTTTTTVVVVVVVVVVVVVVVTMTMMMMMMMMMMBB
BMMBBMMBBBBBBBBMMMMMTTMTTMMMIMMMMTTTMMMMMMMTMMMMIMMMMTTTTTTTTTTTTVVVVVVVVVVVVVVVVVVVVTMMMMMMMMMMTMBB
BBBBBMMBBBBBBBBBMMMTTTTTMMMMMMMMMTTMMMMMMMMMMMMMIMMMMTTTTTTTVVVVVVVVVVVVVVVVVVVVVVVVVTMMMMMMMMMTMMMB
BBBBMTMMTTTTTTTMMMMMMMMTMMMMMMMMTTTMMMMMMMMMMMMMMMMMMVVVVVVVVVVVVVVVVVVVVVVVVVVVVVVVVTMMMMMMMMMTTTMB
BBTTTMMMMMTTTMMMMMMIMTTMMMMMMMMMMMTMMIMMMMMMMMMMMMTGGVVVVVVVVVVVVVVVVVVVVVVVVVVVVVTTTTTMMMMMTTTTTMMB
BBGGTTMMMTMMMIVVVVMMMMMMMMMMMMMMMMTMMMMMMMMMMMMMMTGGGVVVVVVVVVVVVVVVVVVVVVVVVVVVTTTTTMMMMMMMMTTTTMMB
BGGGGGGMTMMMMVVVVVMMMMMMMMMMMMMMMMMMTMMMMMMMMMMMTTGGGVVVVVVVVVVVVVVVVVVVVVVVVVVVTTTMMMMMMMMMTTTTTMMB
BGGGGGGGGGMVVVVVVVVVMMMMMMMMMMMMMMMMTMMMMMMMMMMMTGGGGGVVVVVVVVVVVVVVVVVVVVVVVVVTTTMMMMIMMMMMMMTMMTMB
BGGGGTGGGGVVVVVVVVVVMMMMMTMMMMMMMMMMMMMMMMTMMMMMGGGGGGVVVVVVVVVVVVVVVVVVVVVVVVVTTTMMMMMMMTMMMTMMMTMB
BTGGGGGGGGGVVVVVVVVVMMTMMMMMMMMMMMMMMMMMMMMMMGGMGGGGGGVVVVVVVVVVVVVVVVVVVVVVVVTTTTMMMMMMMMMMMMMMMMTB
BTTGGGTGGGGVVVVVTTTTMMMMMMMMMMMMMMMMMMMMMMMMTGGGGGGGGGVVVVVVVVVVVVVVVVVVVVVVVTTTTMMMMMMMMMMMMMMMMMMB
BBTTTTTTTMTMVVVTTMTMMMMMMMMMMMMMMMTMMMMMMMMMTTGGGGGGGGGVVVVVVVVVVVVVVVVVVVVVTTTTTTMMMMMTMMMMMBBBBBBB
BBBMTTMTMMMMMMTTMMMMMMIMMMMMMMMIMMMTMMMMMMMMTTGGGGGGGGGGVVTTVVVVVTTTTTTTVVTTTTTTMTTMTMMMMBBBBBBBBBBB
BBBTMMMMMMMMMMMMMMMMMMMMMMMMMMMMMMTMMMMTMMMTITTGGGGGGGGGGTTTTTTTTTTTTTTTTTTTMMMMMMTTTMTMMMMBBBBBBBBB
BBBMMMMIMMMMMMMMMMMMMMTMTMMMMMMMMTTMMMMMMMMMMTTGGGGGGGGGGGGGGGMTTMMMTTMTMMTMMMTMMMTTTTTTTMMMMMMMMBBB
BMMMMMMMMMMMMMMMMMMMTMMMTMMMMMMMTTMMMMMMMMMMMTTGGGGGGGGGGGGGGMMMTMMMMMMTMTMTMMMMMMMMTTTTTMMMMMMMMMMB
BMMMMMMMMMTMMMMMMMMMMTMMMTTTTTTTTMIMMMMMMMMMMTGGGGGGGGGGMGGMMMMMTTTMMMTMMMMMMMMMMMMTTTTTTTMMMMTMMMBB
BMMMMMMMMMMMMMMMMMMMMMTTTTTTTTTTTTMMMMMMMMMMMMGGGGGGGGGGMMMMTMMMTTMIMMMMMMMMMMMMMMTTTTTTTTMMMMMMMBBB
BBMMMMMMMMMMMMMMMMMGGGGGGGGGTTTTMMTMMMMMTMMMMMGGGGGGGGMMMMMMMMMMMMMMMMMTMMMGMMMMMMMTTTTTTMMTMMMMMMBB
BBMMMMMMMMMMMMGGGGGGGGGGGGGGGGGTMMMMMMMMMMMMMMGGGGGGGGMMMMMMMMMMMMMMMMMMTGGGGGGGGMMMMTMMMMTTMMMMMMBB
BBMMMMMMTTMMMMTMMMMGGGGGGGGTMMMMMMMMMMMMMMMMMMGGGGGGGGMMMMMMMMMMMMMMTGGGGGGGGGGGGGGGGGMMMMMMMMMMMMBB
BBMMMMMMTMMTTTTTTMMMMMMMGMMMTMMMMMMMMMMMMMMMMMGGGGGGGGMMMMMTMMMMMTMMTTTTGGGGGGGGGMMMMMMMMMMMMMMMMMBB
BBBMMMMMMMTTTTTTTTMMMMMMMMMMMMMMIMTTMMMTMMMMGGGGGGGGGGMMMMMMMMMMMMTTTTTTTTTTTTMMMMMMMMMMMMMMMMMMMMMB
BBMMMTMMMMTTTTTTTMMMMMMMMMMMMTMMMTTTMMMMMGGMGGGGGGGGGGTMMMMMMMMMMIMTTTTTTTTMMMTMMMMMMMMMMTMMMMMMMMMB
BMMMMMMMMMMTTTTTMMMMMMMMTMTMTMMMMMMTMMMGGGGGGGGGGGGGGTTMMMMMMMMMMMTTMMMMMMMTMMMTMMMMMMMMMMMMMMMMMMMB
BBBMMMMMMMMTTTTTTTMMMTMMMTMMTMTTMMMTTMGGGGGGGGGGGGGGGTTMMMMMMMMMMTTMMMMMMMMTMTMMMMMMMMMMMMMMIMMMMBBB
BBBBBBBBBMMMMTMTTTMMMMMMTTTTTTTTTTTTTTTTTTTGGGGGGGGGGTTITMMMTMMMMTMMMMMMMMMMMMMMMMMMMMMMMMMMMMMMTBBB
BBBBBBBBBBBMMMMTMTTMTTTTTTVVTTTTTTTVVVVVTTVVGGGGGGGGGGTTMMMMMMMMTMMMIMMMMMMMMIMMMMMMTTMMMMMMTMTTMBBB
BBBBBBBMMMMMTMMMMMTTTTTTVVVVVVVVVVVVVVVVVVVVVGGGGGGGGGTTMMMMMMMMMTMMMMMMMMMMMMMMMTMTTVVVMTMTTTTTTTBB
BMMMMMMMMMMMMMMMMMMTTTTVVVVVVVVVVVVVVVVVVVVVVVGGGGGGGGGTMMMMMMMMMMMMMMMMMMMMMMMMTTTTVVVVVGGGGTGGGTTB
BTMMMMMMMMMMMMMMMMTTTTVVVVVVVVVVVVVVVVVVVVVVVVGGGGGGMGGMMMMMMMMMMMMMMMMMMMMMMTMMVVVVVVVVVGGGGGGGGGTB
BMTMMMTMMMTMMMMMMMTTTVVVVVVVVVVVVVVVVVVVVVVVVVGGGGGGMMMMMTMMMMMMMMMMMMMMMMTMMMMMVVVVVVVVVVGGGGTGGGGB
BMTMMTMMMMMMMIMMMMTTTVVVVVVVVVVVVVVVVVVVVVVVVVGGGGGTMMMMMMMMMMMTMMMMMMMMMMMMMMMMVVVVVVVVVMGGGGGGGGGB
BMMTTTTTMMMMMMMMMTTTVVVVVVVVVVVVVVVVVVVVVVVVVVVGGGTTMMMMMMMMMMMTMMMMMMMMMMMMMMMMMMVVVVVMMMMTMGGGGGGB
BMMTTTTMMMMMMMMTTTTTVVVVVVVVVVVVVVVVVVVVVVVVVVVGGGTMMMMMMMMMMMMMMTMMMMMMMMMMMMMMMMVVVVIMMMTMMMTTGGBB
BMMTTTTTMMMMMTTTTTVVVVVVVVVVVVVVVVVVVVVVVVVVVVVGGTMMMMMMMMMMMMIMMTMMMMMMMMMMMTTMIMMMMMMTTTMMMMMTTTBB
BMTTTMMMMMMMMMTVVVVVVVVVVVVVVVVVVVVVVVVVVVVVVVVMMMMMMMMMMMMMMMMMMTTTMMMMMMMMTMMMMMMMMTTTTTTTMMTMBBBB
BMMMTMMMMMMMMMTVVVVVVVVVVVVVVVVVVVVVVVVVTTTTTTTMMMMIMMMMMMMMMMMMMTTMMMMMMMMMTTTTTMMMBBBBBBBBBMMBBBBB
BBMTMMMMMMMMMMTVVVVVVVVVVVVVVVVVVVVTTTTTTTTTTTTMMMMIMMMMTMMMMMMMTTTMMMMIMMMTTMTTMMMMMBBBBBBBBMMBBMMB
BBMMMMMMMMMMTMTVVVVVVVVVVVVVVVTTTTTTTTTTTTTTTTMMMMMMMMMTMMMMMMMTMTTMMMMMMMMMTTTMMMMMMMMMBBMMMMMMMMMB
BBMMMMMMMMMMMTTTVVVVVVVVVVVGGTTMMMTTTTTTTMMMMMMMMMMMMMMMMMMMMMMMMTTMMMMMMMMTTTTMMTMMMMMMMMMMMMMMMMMB
BMMMMMTMMMMMMTTTVVVVGGGGGGGGMMMMMTTTMMTMMTTMMMMMMMMMMMMMMMMMMMMMTTTMMMMMMMMTTTTTMMMMMTMMMMMMTMMMMMBB
BMMMMMMMMMTMMMTTVVVGGGGGGMMMMMMITMTTMMMMMMMMMMMIMMMMMMMMMMMMMMMTTMMMMMMMMMMMTTTMMMMMMMTMMMMMMMMMMMBB
BBMMMMMMMMTMMMTTVGGGGTGGMMMMMMMMMTTMMMMMTMMMTMMMMMMMMMMMMMMMMMMMMMMMTTMMMMMMTTMMMMMMMMMMMMMMTMTTTTMB
BBBMMMMMMMMMMTTVVGGTTTMMMMMMMMMMMMMMMMMMMMTTTMMMMMMMMMMMMMMMMMMMMMTMMMMMMMMMTMMMMMMMMTMMMMMMMMTTTMBB
BBBBBMMMTTMMTTTTVVTTMMMTTMMMMMMMMMMMMMMMTMTTTTMMMMMMMMMMMMIMMMMMMMMMMMMMMMMTTMMMMMMTTMTMMTTTTMMTTTBB
BBBMMMMMTTTTTTTTTTTMMMTTTTTMMMMMMMMMMMMMMMTTTTMMMMMMMMMMMMMMMMMMMMMMMMMMMMMTMMMMMMMMMTMMMMTMMMMMTMBB
BBMMTMMTTMMMMTTTTTTTMMTTTTTTTMMMMMMMMMMMMMMTTTTMMMMMMMMIMMMMMMMMMIMMMMMMMTTTMMMMMMMMMMMTTMMTMMMMMMBB
BBMTMMMMMMMMMTMTTMMTMMTTTTTTMMMMMMMMMMMMMMTMTTTTTMMMMMMMMMMMMMMTTMTTMMMMMTTMMMMMMMMMMMMMMTTTTMMMMMMB
BMMMMMMMMMMMTTMMMMMMTMMMTTTMMMMMMMMMMMMMMMMMMMTTTTTMMMMMMMTMMTTTMMMMMMMMMTMMMMMMMMMMMMMTTMTMMMMMMMMB
BMMMMMMMMMMMTTMMMMMMMMMMMMMMMMMMMMMMMMMMMMMMMMMMMTTMMMMMMTMMMMMTTTMMMMMMTMMMMMMMMMMMMTTTTMTTTTTTMMBB
BMBMMMMMMMMMTTMMMMMMMMMMMMMMMMMMMMMIMMMMMMMMMMMMMMMMMMMMMMMMMMMMMMMMMMMMMMMMMMIMMMMMMMTTTTTTTTTTTMMB
BBBMMMMMMMTTMMMMMMMMMMMMMMMMMMMMMMMMTMMMMMMMMMMMMMMMMMMMMMMMMMMMMMMMMMMMMMMMMMMMMMMTMMMMMTTTTTMTTMMB
BBBMMMMTTTTTTMMTTMMMMMMMMTMMIMMMMMMMMMMMMMMMMMMMMMMMMMMMMMMMMMMMMMMMMMMMMMMMMMMMMMMMMMMTTTTTTTTMMMBB
BBBMMMMTTTTTTTTMTMMMMMMMMMMMMMMMMMMMMMMMMMMMMMMMMBBBBBBMMMMMMMMMMMMMMMMMMMMMMMMMMMMMMTMMTTTTTMMTMMMB
BBMMMMMMTTTTTTTMMMMMMMMMMMMMMMMMMMMMMMMMMMMMMMMMMBBBBBBMMBBBBMMMMBBMMMMIMMMMMMMMMMMTTTMMTTTMMMTTMMMB
BBMMMMMMMMMMTTTTMMTMIMMMMMMMMMMMMMMMMMMMMMMMMMMMBBBBBBBBBBBBBBBBBBBBBBBIMMMMMTMMMMMMMMMMMMMMMMTTMMMB
BBMMMMMMTMMTMTTTTMMMMMMMMMMMMMMMMMMMMMMMTMMMMMMMBBBBBBBBBBBBBBBBBBBBBBBBMMMMMMMMMMMMMMMMMMMMMMMMTMMB
BMMMMMMTMMMMTMTTTTMMMMMMMMMMMMMMMMMMMMTMTMMMMMMBBBBBBBBBBBBBBBBBBBBBBBBMMMMMMMMMMMMMMMMMTTTTMMMMMMBB
BBMMMMMMMMMMMMMTTTTTTMMMMMVVVMMMMMMMMTMTTMMMMMMMBBBBBBBBBBBBBBBBBBBBMMMMMMMMMMMMMMMMMMMTTMTMMMMMMMBB
BBMMMTMMMMMMMMMTTTTTTTTTMMVVVMMMMMMMMMMTTMMMMMMMMBBBBBBBBBBBBBBBBBBMMMMMMMIMMMMMMMMMMMMMMMMMMMIMMMMB
BBMMMMMMMMMMMMMMMMMTTMMVVVVVVMMMMMMTMTTTTMMTMMMMMMMMMMTTTTMMMMMMMMMMMMMMMMMMMMMMMMMMMMMMMTMMMMMMMMBB
BMMMMMMMMMMMMMMMMMMTMTMVVVVVTMMMMMMMTTTTTMMMMMMMTMTMMMMTMMMMTTTTMMMMMMMTMMMMMMMMMMMMMMMMTTMMMMIMMMBB
BMMMMMMMMMMMMIMMMTTTMMMMMMTTTMMMMTMMMMTTTTMMMMMMTMMMTMMMTTTTTTTTTMMMMMMMMMMMMMMMMMIMMMMMMMMMMMMMMBBB
BBMMMMMTMMMMMMMMMMMMMMTMMMMMMTMMMMMMMMTMMMMMMMMTMMMMTTTTTTTTTTTTTTMMMMMMMMMIMMMMMMMMMMMMMMMMMMMMMBBB
BBBMMMMMMMMMMMMMMMMMMMTMMMMMMMMMMMMMMTMMMMMMMMMMMMMTMMMMTTMMMMTTMMMMMMMMMMMMMMMMMMMMMMMMSMMMMMMMMMMB
BBBMMMMMMMMMMMMMMMMMMMMMMMMMMMMMMMMMMMMMMMMMTMMMMBMMMMTMMMTMMMMMTTMMMMMMMMMMMMMMMMMMMMMMMMMMMMTMMMMB
BBBMMMMMBBBMMBBMMMBBBMMMMMMMMMMMMMMMMMMMMMMMMMBBBBMMMMMMMMMMMMMTMMMMMMMMMMMMMMMMMMMMMBBBMMMMMMMMMMBB
BBBBMMMBBMMMBBBMMBBBBBBBMMMBBBMMMMMBBBBMBBMMMMMBBBMMMMMMMMBBBBBMBBMMBMMMBBBMMMMMMMBBBBBBBBBBBMMMBBBB
BBBBBBBBBBBBBBBBBBBBBBBBBBBBBBBBBBBBBBBBBBBBBBBBBBBBBBBBBBBBBBBBBBBBBBBBBBBBBBBBBBBBBBBBBBBBBBBBBBBB